##########
#A.#.#...#
#.#.##.#.#
#.#.##.#.#
#.#....#B#
###.##.#.#
#....#...#
##########
